7 8
WWWWWWWW
W.....EW
W.WWWW.W
W....W.W
W.WW.W.W
WS.....W
WWWWWWWW