9 9
WWWWWWWWW
W......EW
W.WWWWW.W
W....SW.W
W.WWW.W.W
W...W.W.W
W.W.W.W.W
W.......W
WWWWWWWWW