9 9
WWWWWWWWW
W......EW
W.WWWWW.W
W.....W.W
W.WWW.W.W
W..SW.W.W
W.W.W.W.W
W.......W
WWWWWWWWW