7 17
WWWWWWWWWWWWWWWWW
W...............W
W.W.W.W.W.W.W.W.W
WS.............EW
W.W.W.W.W.W.W.W.W
W...............W
WWWWWWWWWWWWWWWWW
