5 10
WWWWWWWWWW
W.......EW
W.WWWWWWWW
W.......SW
WWWWWWWWWW