7 8
WWWWWWWW
W.....EW
W.WWWWWW
W.W
W.WWWWWW
WS.....W
WWWWWWWW