7 8
WWWWWWWWWWWW
W.....EWWWWW
W.WWWW.W
W....W.WWWWW
W.WW.W.W
WS.....WWWWW
WWWWWWWWWWWW