5 5
WWWWW
W..EW
WW.WW
W..SW
WWWWW