8 9
WWWWWWWWW
W.....W.W
W.WW..E.W
W.WWWW.WW
W....W..W
W.WW.WW.W
WS......W
WWWWWWWWW