10 9
WWWWWWWWW
W.......W
W.WWWWW.W
W.W...W.W
W.WEW.W.W
W.WWW.W.W
W.....W.W
WWWWWWW.W
WS......W
WWWWWWWWW