9 9
WWWWWWWWW
W......EW
W.WWWWWWW
W.......W
WWWWWWW.W
W.......W
W.WWWWWWW
W......SW
WWWWWWWWW