9 9
WWWWWWWWW
W......EW
W.WWWWW.W
W.....W.W
W.WWW.W.W
W...W.W.W
W.W.W.W.W
WS......W
WWWWWWWWW